0 0 0 0 0 0 0 0 0 0 0 0 0 0 0 0 0 0 0 0 
0 0 0 0 0 0 0 0 0 0 0 0 0 0 0 0 0 0 0 0 
0 0 0 0 0 0 0 0 0 0 0 9 4 4 4 8 0 0 0 0 
0 0 0 0 0 0 0 0 0 0 0 6 12 12 12 5 0 0 0 0 
0 0 0 0 0 0 0 1 2 3 0 6 12 12 12 5 0 1 2 3 
0 0 0 0 0 0 0 0 0 0 0 6 12 12 12 5 0 0 0 0 
0 0 0 0 0 0 0 0 0 0 0 6 12 12 12 5 0 0 0 0 
4 4 4 8 0 1 2 3 0 0 0 6 12 12 12 5 0 0 0 0 
12 12 12 5 0 0 0 0 0 0 0 6 12 12 12 5 0 0 0 0 
12 12 12 5 0 0 0 0 0 0 0 6 12 12 12 5 0 0 0 0 
12 12 12 5 0 0 0 0 0 0 0 6 12 12 12 5 0 0 0 0 
12 12 12 12 4 4 4 4 4 4 4 12 12 12 12 12 4 4 4 4 
12 12 12 12 12 12 12 12 12 12 12 12 12 12 12 12 12 12 12 12 
0 0 0 0 0 0 0 0 0 0 0 0 0 0 0 0 0 0 0 0 
0 0 0 0 0 0 0 0 0 0 0 0 0 0 0 0 0 0 0 0 
0 0 0 0 0 0 0 0 0 0 0 0 0 0 0 0 0 0 0 0 
0 0 0 0 0 0 0 0 0 0 0 0 0 0 0 0 0 0 0 0 
0 0 0 0 0 0 0 0 0 0 0 0 0 0 0 0 0 0 0 0 
0 0 0 0 0 0 0 0 0 0 0 0 0 0 0 0 0 0 0 0 
0 0 0 0 0 0 0 0 0 0 0 0 0 0 0 0 0 0 0 0 