00000000000000000000
00000000000000000000
00000000000000000000
00000000000000000000
00000012300000000000
00000000000000000000
00123000001230000000
00000000000000000000
00000000000000000000
00000000000000000000
12222222222222222223
00000000000000000000
00000000000000000000
00000000000000000000
00000000000000000000
00000000000000000000
00000000000000000000
00000000000000000000
00000000000000000000
00000000000000000000